8
6
06333300
06333300
36303303
35666663
66303320
66333300