7
7
3333333320
0000630300
3303630300
3303566666
3333630300
3300630300
3300633300