10
7
0333333333
0333332033
0333330033
6665666633
0336330033
0336333333
0336000000